BD5513D153
C5556C5696
95155157C3
AFAF96FFFA
AFEFC157FA
AFFF92FFFA
AD3FAEFD52
C3AFC3FFFA
BC453C553A
C5554557C6

1,2
1,9
WSSSSSESEEESWWW
