d 5 5 3 d 5 1 5 3 b
9 5 3 c 5 5 6 b c 2
e 9 4 3 9 1 5 4 7 a
9 2 d 4 6 e 9 3 9 6
a a 9 5 5 5 6 c 6 b
a a a 9 5 1 1 7 9 2
a e a c 3 a e 9 6 a
a 9 6 9 6 c 5 6 9 2
a c 3 c 7 9 5 3 a a
c 5 4 5 5 6 d 4 6 e
